NO ./makefile
SO ./makefile
WE ./makefile
EA ./makefile
F 079,255,051
C 51,156,255

111111111111111111111111111111
1S1000000000001000000000000101
100111111110111111111111110101
100010000010000000010000010001
101011111010111111010111110101
101000001010000001010000010101
101111101011111011010111010101
100000101010000010010001010001
101110101011111010010111011101
101000100000010010010000000101
101011101110101111010111110101
101000000010001000000000010101
101111111111111111111111111101
100000000000000000000000000001
111111111111111111111111111111