NO ./makefile
SO ./makefile
WE ./makefile
EA ./makefile
F 079,255,051
C 51,156,255

1111111111111111111111111
1000000000000000000000001
1000000000000000000000001
1100000000000000000000001
1110000000000000000000001
  1000000000000000000000001
1110000000000000000010001
1111111000000000000000001
1000000000000000010000001
1000000000000010000000001
1000000000000000000000001
10000000000000N0000000001
1000000000000000000000001
1111111111111111111111111
