NO ./makefile
SO ./makefile
WE ./makefile
EA ./makefile
F 079,255,051
C 51,156,255

11111111111111111   11111
10000000000000001   11001
10000000000000001   10001
1000000000000000111110001
1000000000000000000000001
1100000000000000000000001
1000000000000000000000001
1000000000000000000000001
1000000000000000000000001
1000000000000000000000001
1000000000000000000000001
1000000000000000000000001
1000000000000000000000001
1000000000000000000000001
1000000000000000000000001
1000000000000000N00000001
1000000000000000000000001
1100000000000000000000001
1000000000000000000000001
11111000000000000000000011111
    1000000000000000000000011
11111000000000000000000011111
1100000000000000000000001
1100000000000000010000001
1111111111111111111111111
